%%%%%%%%%%%%%%%%%%%%%%%%%%%%%%%%%
% o    ......................   % 
% .      %%%%%   .  %      %% . %
% .    %%        .  %    %%   . %
% .    %         .  %  %%     . %
% .  G %   o P   .  %%        . %
% .    %         .  %  %%     . %
% .    %%        .  %    %%   . %
% .      %%%%%   .  %      %% . %
% .    .......................  %
%%%%%%%%%%%%%%%%%%%%%%%%%%%%%%%%%