%%%%%%%%%%%%%%%%%%%%%%%%%%%%%%%%%
% o    ......................   % 
% .      %%%%%   .  %      %% . %
% .    %        .   %    %%   . %
% .    %         .  %  %%     . %
% .  G %   o P   .  %%        . %
% .    %         .  %  %%     . %
% .    %        .   %    %%   . %
% .      %%%%%   .  %      %% . %
% .    .......................  %
%%%%%%%%%%%%%%%%%%%%%%%%%%%%%%%%%